|........|
|...|....|
|...|.@..|
|........|
|........|